#1
12 12
6 9
	   1  1  1  1  1  1  1  1  1  1  1  1   
	   1  0  0  0  0  4  4  4  0  0  0  1   
	   1  0  0  0  0  0  0  0  0  0  0  1   
	   1  0  0  0  0  0  0  0  0  0  0  1   
	   1  0  1  1  1  1  1  1  1  0  0  1   
	   1  0  0  0  0  0  0  0  0  0  0  1   
	   1  0  0  0  0  0  0  0  0  0  0  1   
	   1  0  0  2  0  0  0  0  0  0  0  1   
	   1  0  0  0  0  0  0  2  0  0  0  1   
	   1  0  0  0  2  0  0  0  0  0  0  1   
	   1  0  0  0  0  0  0  0  0  0  0  1   
	   1  1  1  1  1  1  1  1  1  1  1  1  
#2
12 9
4 1
	   1  1  1  1  1  1  1  1  1  1  1  1   
	   1  0  0  0  0  4  0  0  0  0  0  1   
	   1  0  0  0  0  0  0  0  0  0  0  1   
	   1  0  0  0  0  0  0  0  0  0  0  1   
	   1  0  1  1  1  1  1  1  1  0  0  1   
	   1  0  0  0  0  0  0  0  0  0  0  1   
	   1  0  0  2  0  0  0  0  0  0  0  1   
	   1  0  0  0  0  0  0  0  0  0  0  1   
	   1  1  1  1  1  1  1  1  1  1  1  1  
#3
11 9
4 2
	   1  1  1  1  1  1  1  1  1  1  1   
	   1  0  0  0  0  4  0  0  0  0  1   
	   1  0  0  0  0  0  0  0  0  0  1   
	   1  0  0  0  0  0  0  0  0  0  1   
	   1  0  1  1  1  1  1  1  0  0  1   
	   1  0  0  0  0  0  0  0  0  0  1   
	   1  0  0  2  0  0  0  0  0  0  1   
	   1  0  0  0  0  0  0  0  0  0  1   
	   1  1  1  1  1  1  1  1  1  1  1  